111111111
10E000101
100001001
10C010001
100101101
10P000001
111111111
