1111111111
1P00C0E111
1111111111
