111111111
10CCCCCE1
1C11C11C1
1C11111C1
1C11111C1
10C111C01
100C1C001
1P00C0001
111111111
