11111111111111111111111111111111111111111111111
100000000000000000011111111111100000000010000E1
100010000000000000000000C000001000000001C100001
100C0000000000000000000000000010000000100010001
11000000000000000000000000000010000001000001001
10000000000000000000000000000010000000000000101
10000000011111100000010000000000000000000000001
10000011111C011100000100000000000011111C0000001
10000000000000000000010000000000000000000000001
10000001111011110000010000000000000000000000001
10000001111C11110000011000000000001111000000001
10000000000000000000111100000000000011000000001
1P0000000001111111111111000000000000C1000000001
11111111111111111111111111111111111111111111111
