11111111111111111111111111111111111111111111111
100000111111000000010100000000000000000000000E1
100011000000110000010100C000000001001110C111001
10011000000001100111010010000000010111111111101
10011000000001100001010010000000010011111111001
10001100000011000111010010000000010000111100001
100000111C1100000001010010000000010000011000001
10000000000000000001010011111110010000000000001
10000000000000000000000000000000010000000000001
10000001111111111000000000000000010000000000001
10000001000C00001000000000000000010000000000001
10000001111111101000000000000000000000000000001
1P0000000000000000000000000000000000C0000000001
11111111111111111111111111111111111111111111111
